.................
.
.
.....#######
.....#p....#
.....#..#..#
.....#..#..#
.....#..#..#
.....#....f#
.....#######
.
.
.