#######
#p....#
#.....#
#.....#
#.....#
#....f#
#######