#######
#p....#
#.....#
#.....#
#.....#
#######