.................
.
.
.....#######
.....#p.#..#
.....##.#..#
.....##.####
.....##....#
.....#.###f#
.....#######
.
.
.